NO ./textures/nica.xpm
SO ./textures/nica.xpm
WE ./textures/bono.xpm
EA ./textures/bono.xpm

F 59,63,66
C 0,0,34

11111111111
1E000000001
11111111111
