NO ./textures/nica.xpm
SO ./textures/nica.xpm
WE ./textures/bono.xpm
EA ./textures/bono.xpm

F 59,63,66
C 0,0,34

1111111111111111111111111111111111111111111111111111111111111111111111111111111111111
1000000000000000000000000000000000000000000000000000000000000000000000000000000000001
1001001001001001001001001001001001001001001001001001001001001001001001001001001001001
1000100100100100100100100100100100100100100100100100100100100100100100100100100100101
1000000000000000000000000000000000000000000000000000000000000000000000000000000000001
1001001001001001001001001001001001001001001001001001001001001001001001001001001001001
1000100100100100100100100100100100100100100100100100100100100100100100100100100100101
1000000000000000000000000000000000000000000000000000000000000000000000000000000000001
1001001001001001001001001001001001001001001001001001001001001001001001001001001001001
1000100100100100100100100100100100100100100100100100100100100100100100100100100100101
1000000000000000000000000000000000000000000000000000000000000000000000000000000000001
1001001001001001001001001001001001001001001001001001001001001001001001001001001001001
1000100100100100100100100100100100100100100100100100100100100100100100100100100100101
1000000000000000000000000000000000000000000000000000000000000000000000000000000000001
1001001001001001001001001001001001001001001001001001001001001001001001001001001001001
1000100100100100100100100100100100100100100100100100100100100100100100100100100100101
1000000000000000000000000000000000000000000000000000000000000000000000000000000000001
1001001001001001001001001001001001001001001001001001001001001001001001001001001001001
1000100100100100100100100100100100100100100100100100100100100100100100100100100100101
1000000000000000000000000000000000000000000000000000000000000000000000000000000000001
1001001001001001001001001001001001001001001001001001001001001001001001001001001001001
1000100100100100100100100100100100100100100100100100100100100100100100100100100100101
1000000000000000000000000000000000000000000000000000000000000000000000000000000000001
1001001001001001001001001001001001001001001001001001001001001001001001001001001001001
1000100100100100100100100100100100100100100100100100100100100100100100100100100100101
1000000000000000000000000000000000000000000000000000000000000000000000000000000000001
1001001001001001001001001001001001001001001001001001001001001001001001001001001001001
1000100100100100100100100100100100100100100100100100100100100100100100100100100100101
1000000000000000000000000000000000000000000000000000000000000000000000000000000000001
1001001001001001001001001001001001001001001001001001001001001001001001001001001001001
1000100100100100100100100100100100100100100100100100100100100100100100100100100100101
1000000000000000000000000000000000000000000000000000000000000000000000000000000000001
1001001001001001001001001001001001001001001001001001001001001001001001001001001001001
1000100100100100100100100100100100100100100100100100100100100100100100100100100100101
1000000000000000000000000000000000000000000000000000000000000000000000000000000000001
1001001001001001001001001001001001001001001001001001001001001001001001001001001001001
1000100100100100100100100100100100100100100100100100100100100100100100100100100100101
1000000000000000000000000000000000000000000000000000000000000000000000000000000000001
1001001001001001001001001001001001001001001001001001001001001001001001001001001001001
1000100100100100100100100100100100100100100100100100100100100100100100100100100100101
1000000000000000000000000000000000000000000000000000000000000000000000000000000000001
1001001001001001001001001001001001001001001001001001001001001001001001001001001001001
1000100100100100100100100100100100100100100100100100100100100100100100100100100100101
1000000000000000000000000000000000000000000000000000000000000000000000000000000000001
1001001001001001001001001001001001001001001001001001001001001001001001001001001001001
1000100100100100100100100100100100100100100100100100100100100100100100100100100100101
1000000000000000000000000000000000000000000000000000000000000000000000000000000000001
1001001001001001001001001001001001001001001001001001001001001001001001001001001001001
1000100100100100100100100100100100100100100100100100100100100100100100100100100100101
1000000000000000000000000000000000000000000000000000000000000000000000000000000000001
1001001001001001001001001001001001001001001001001001001001001001001001001001001001001
1000100100100100100100100100100100100100100100100100100100100100100100100100100100101
1000000000000000000000000000000000000000000000000000000000000000000000000000000000001
1001001001001001001001001001001001001001001001001001001001001001001001001001001001001
1000100100100100100100100100100100100100100100100100100100100100100100100100100100101
1000000000000000000000000000000000000000000000000000000000000000000000000000000000001
1001001001001001001001001001001001001001001001001001001001001001001001001001001001001
1000100100100100100100100100100100100100100100100100100100100100100100100100100100101
1N00000000000000000000000000000000000000000000000000000000000000000000000000000000001
1111111111111111111111111111111111111111111111111111111111111111111111111111111111111